+-+-+-+-+-+-+-+-+-+-+
S   |       | |   | |
+-+ + +-+-+ + + + + +
| | |   |   |   |   |
+ + +-+ + +-+ + +-+-+
|       |   | | |   |
+ +-+-+-+-+ + +-+ + +
| |         |   | | |
+-+ +-+-+ +-+-+ + + +
S   |     | |   | | |
+ +-+ + + + + + + +-+
|             | |   |
+-+ +-+-+ + +-+ +-+ +
| | |     | |   |   |
+ + + +-+-+-+ +-+ +-+
|   | |   |   |   | |
+-+-+ + + + +-+ +-+ +
| |   | | |     |   |
+ + + +-+ +-+-+ + + +
|   |             | F
+-+-+-+-+-+-+-+-+-+-+
